------------------------------------------------------------------------------------------------------------------------------------------------------S-------------------------------------------------
------------------------------------------------------------------------------------------------------------------------------------------------------S-------------------------------------------------
-----------------------------------------------------------------------------------------------------SSSSSSSBBBBBTBBBBBBBBBBBBBBBBBSSSSSSS------------S-------------------------------------------------
----------------------------------------------------------------------------------------------------S------------------------------------SS-----RRRRR-S-------------------------------------------------
---------------------------------------------------------------------------------------------------S--------------------------------------S-----R---R-S-------------------------------------------------
--------------------------------------------------------------------------------------------------S---------------------------------------SS---RR---RRS-------------------------------------------------
-------------------------------------------------------------------------------------------------S-----------------------------------------SS--R-----RS-------------------------------------------------
------------------------------------------------------------------------------------------------S-------------------------------------------SSSSSSSSSSS-------------------------------------------------
-----------------------------------------------------------------------------------------------S--------------------------------------------------------------------------------------------------------
----------------------------------------------------------------------------------------------S---------------------------------------------------------------------------------------------------------
---------------------------------------------------------------------------------------------S----------------------------------------------------------------------------------------------------------
--------------------------------------------------------------------------------------------S-----------------------------------------------------------------------------------------------------------
-------------------------------------------------------------------------------------------S------------------------------------------------------------------------------------------------------------
------------------------------------------------------------------------------------------S-------------------------------------------------------------------------------------------------------------
-----------------------------------------------------------------------------------------S--------------------------------------------------------------------------------------------------------------
----------------------------------------------------------------------------------------S---------------------------------------------------------------------------------------------------------------
---------------------------------------------------------------------------------------S----------------------------------------------------------------------------------------------------------------
--------------------------------------------------------------------------------------S-----------------------------------------------------------------------------------------------------------------
-------------------------------------------------------------------------------------S------------------------------------------------------------------------------------------------------------------
------------------------------------------------------------------------------------S-------------------------------------------------------------------------------------------------------------------
-----------------------------------------------------------------------------------S--------------------------------------------------------------------------------------------------------------------
----------------------------------------------------------------------------------S---------------------------------------------------------------------------------------------------------------------
---------------------------------------------------------------------------------S----------------------------------------------------------------------------------------------------------------------
--------------------------------------------------------------------------------S-----------------------------------------------------------------------------------------------------------------------
-------------------------------------------------------------------------------S------------------------------------------------------------------------------------------------------------------------
------------------------------------------------------------------------------S-------------------------------------------------------------------------------------------------------------------------
-----------------------------------------------------------------------------S--------------------------------------------------------------------------------------------------------------------------
----------------------------------------------------------------------------S---------------------------------------------------------------------------------------------------------------------------
---------------------------------------------------------------------------S----------------------------------------------------------------------------------------------------------------------------
--------------------------------------------------------------------------S-----------------------------------------------------------------------------------------------------------------------------
--------------------------------------------------------------------SSSSSSSSSSSSSSSBBBBBBBBBBBBBBBBBBBBBBBBBBBBBBBBBBBBBBBBSSSSSSSSSSSSSSS--------------------------------------------------------------
-------------------------------------------------------------------SSSSSSSSSSSSSSSS----------------------------------------SSSSSSSSSSSSSSSS-------------------------------------------------------------
------------------------------------------------------------------SSS------------SS----------------------------------------SS------------SSS------------------------------------------------------------
-----------------------------------------------------------------SSS-------------SS----------------------------------------SS-------------SSS-----------------------------------------------------------
----------------------------------------------------------------SSS--------------SS----------------------------------------SS--------------SSS----------------------------------------------------------
---------------------------------------------------------------SSS---------------SS----------------------------------------SS---------------SSS---------------------------------------------------------
--------------------------------------------------------------SSS----------------SS----------------------------------------SS----------------SSS--------------------------------------------------------
-------------------------------------------------------------SSS-----------------SS----------------------------------------SS-----------------SSS-------------------------------------------------------
------------------------------------------------------------SSS------------------SS----------------------------------------SS------------------SSS------------------------------------------------------
-----------------------------------------------------------SSS-------------------SS----------------------------------------SS-------------------SSS-----------------------------------------------------
----------------------------------------------------------SSS--------------------SS----------------------------------------SS--------------------SSS-----------------------------------------------S---S
---------------------------------------------------------SSS---------------------SS----------------------------------------SS---------------------SSS----------------------------------------------S--SS
--------------------------------------------------------SSS----------------------SS----------------------------------------SS----------------------SSS---------------------------------------------S-SSS
-------------------------------------------------------SSS-----------------------SS----------------------------------------SS-----------------------SSS--------------------------------------------SSSCS
------------------------------------------------------SSS------------------------SS----------------------------------------SS------------------------SSS-------------------------------------------SCCCS
-----------------------------------------------------SSS-------------------------SS----------------------------------------SS-------------------------SSS------------------------------------------SCCCS
-----------------------------------------------------SS--------------------------SS----------------------------------------SS--------------------------SS------------------------------------------SCCCS
DDDDDDDDDDDD-------------------------------DDDDDDDDDDDDDDDDDDDDDDDDDDDDDDDDDDDDDDDD----------------------------------------DDDDDDDDDDDDDDDDDDDDDDDDDDDDDDDDDDDDDDD---------------------------------SCCCS
DDDDDDDDDDDDD-----------------------------DDDDDDDDDDDDDDDDDDDDDDDDDDDDDDDDDDDDDDDDD----------------------------------------DDDDDDDDDDDDDDDDDDDDDDDDDDDDDDDDDDDDDDDD--------------------------------SCCCS
-----------DDD---------------------------DDDD--------------------------------------------------------------------------------------------------------------------DDD-------------------------------SCCCS
-----------DDDD-------------------------DDDD---------------------------------------------------------------------------------------------------------------------DDDDD-----------------------------SCCCS
------------DDDD-----------SSSSSSS-----DDDD-----------------------------------------------------------------------------------------------------------------------DDDDD----------------------------SCCCS
-------------DDDD----------SS---SS----DDDD--------------------------------------------------------------------------------------------------------------------------DDDD---------------------------SCCCS
--------------DDDD--------------SS---DDDD----------------------------------------------------------------------------------------------------------------------------DDDD--------------------------SCCCS
---------------DDDD--------SS---SS---DDDD-----------------------------------------------------------------------------------------------------------------------------DDDDDD-----------------------SCCCS
----------------DDDD-------SS---SS-DDDDDD------------------------------------------------------------------------------------------------------------------------------DDDDDDDD--------------------SCCCS
-----------------DDDDDDDDDDDDDDDDDDDDDDDD---------------------------------------------------------------------------------------------------------------------------------DDDDDD-------------------S---S
------------------DDDDDDDDDDDDDDDDDDDDD--------------------------------------------------------------------------------------------------------------------------------------DDDD------------------S---S
------------------------------------------------------------------------------------------------------------------------------------------------------------------------------DDDDDD---------------S---S
-------------------------------------------------------------------------------------------------------------------------------------------------------------------------------DDDDDDDDDDDDDDDDDDDDDDDDD
----------------------------------------------------------------------------------------------------------------------------------------------------------------------------------DDDDDDDDDDDDDDDDDDDDDD
--------------------------------------------------------------------------------------------------------------------------------------------------------------------------------------------------------
--------------------------------------------------------------------------------------------------------------------------------------------------------------------------------------------------------
--------------------------------------------------------------------------------------------------------------------------------------------------------------------------------------------------------
--------------------------------------------------------------------------------------------------------------------------------------------------------------------------------------------------------
--------------------------------------------------------------------------------------------------------------------------------------------------------------------------------------------------------
--------------------------------------------------------------------------------------------------------------------------------------------------------------------------------------------------------
--------------------------------------------------------------------------------------------------------------------------------------------------------------------------------------------------------
--------------------------------------------------------------------------------------------------------------------------------------------------------------------------------------------------------
